###################
# Player 2        #
# Round:   3      #
# Kills: 0        #
# Lives: 0        #
# Missiles: 0/1   #
###################
#       XXX       #
#      VVV        #
# ---   ---   --- #
# ---   ---   --- #
# ---   ---   --- #
#                 #
#                 #
#                 #
#                 #
#                 #
#       x  x  x   #
#                 #
#       x  x  x   #
#                 #
#                 #
#                 #
#                 #
#                 #
# ---   ---   --- #
# ---   ---   --- #
# ---   ---   --- #
#        AAA      #
#       MMM       #
###################
# Missiles: 0/2   #
# Lives: 0        #
# Kills: 0        #
# Round:   3      #
# Player 1        #
###################

